111111111111111111111111111111
110011111111144411111111441111
111111111111111111111111111111
111111111111111111114411111111
333333333311111111111111111111
111111111111111111111111111111
111222222222222222222222211111
111111222222211113333333333333
114411111111111111111111111111
111111111111111111111111111111
111111111111144111111111111111
111111111111111111111133331111
111111111111111111111111131111
111111111111111111111111131111
333333333333111111111111111111
111111111111111114441111111111
111444111111111111111111111111
111111111111111111111111111111
17