333333333333333333333333333333
311113144113111113111113111413
311113111113111113111113122223
311111111111111111111111111113
333112113111113112213311113313
311111122111111111112211111113
312213144113111113114113111413
314413111113122213111113111113
311111111111111111111111111113
333111113111113111113121113313
311111111111222111111111111113
311113111113114113111113111113
311213114113122213111113111113
311111111111111111111111111113
333111113111113111113112213313
314111111111111111111111111113
311223111113112113111413111413
333333333333333333333333333333

