333333333333313333333333333333
111111111111111111111111111111
111111111111111111122222222201
111111111133333333333333333333
111111111111111111111111111221
111111111111111111111111112221
000002000000000000000000002211
011111111111111111111112001221
000000000000000111100000001111
111111111111111111111111111111
000000000022200000000000000000
000000000000000000000000000000
222000000000000000000002222222
222222221222222222222222222222
111111111111111111111111111111
111111111111111111111111111111
111111111111111111111111111111
333333333333331333333333333333