333333333333333333333333333333
111111111111111111111011111423
312411011111111111111111114213
311241111111101111111111142113
311124111111100011111111421113
311112411111111111111114211113
311111241111142421111142111113
311111124111124241111421111113
311111112411142421114211111113
311111112411111111114211100113
311101124111111111111421111113
311111241111111111111142111113
311112411111111111111114211113
311124111111100011111111421113
311241111111111111111111142113
312411100001111111111111114213
324111111111111000111111111423
333333333333333333333333333333