333333333333333333333333333333
301111111111122222222211111113
331114111122222211111111222223
331111111111111111111222111113
331112222111112222211111111213
311133311111221111111111112113
311111122221111112222214411113
311112222211111111111111122213
313311111111222221111111111113
311111111111111111122222111113
311122211111111111111111113113
311144411122222211111114111113
311111111111111111111111113143
312222221111111111112222211113
311111111112223333331111113413
311111333314111111111111111123
311111111111111111111111113143
333333333333333333333333333333