111113122113111113111113111113
111113144113111113111113111413
111113111113111113111113122223
111113111113111113111113111113
333312133311133312233311133313
111113111113111113112213111113
222213144113111113114113111413
144113111113122213111113111113
111113111113111113111113111113
333311133311133311133321133313
111113111113222113111113111113
111113111113114113111113111113
411213114113122213111113111113
111113111113111113111113111113
333311133311133311133312233313
114113111113111113111113111113
111223111113112113111413111413
111113111113111113111113111113